WWWWWWWWWWWWWWWWWWWWWWWWWWWWWWW
W     W     W                 W
W   WWW     WW      W   WWWW WW
W   W    W   WW WWWW       W  W
W   W    W   WW  W         W  W
W   W   WW    W  WWW  W W  WW W
W  WW   WW    W       W    W  W
W       W               W     E
W       W             W W     E
WWWWWWWWWWWWWWWWWWWWWWWWWWWWWWW
WWWWWWWWWWWWWWWWWWWWWWWWWWWWWWW